kisu = knife
kiti = chair
kofia = hat
lango = door
rangi = color
sauti = voice
bustani = garden
tabibu = doctor
tumbili = monkey
basi = bus
baskeli = bike
afisi = office
keja = house
bahari = sea
roho = soul
kijana = boy
baba = father
chanjo = scissors
kitanda = bed
barua = letter
ujuzi = knowledge
askari = police
kanisa = church
dhoruba = storm
samaki = fish
kioo = mirror
saduku = box
skati = skirt
degaga = glasses
chakula = food
rafiki = friend
bibi = grandmother
anga = sky
ufu = death
chama = society
karamu = party
adui = enemy
chunga = pot
kamba = rope
tofaa = apple
chapati = bread
pombe = beer
jicho = eye
likizo = holidays
kaputula = pants
wakati = alarm
ajabu = wonder
shukuru = thanks
siri = secret
jiwe = stone
tunda = fruit
kuku = chicken
kichwa = head
jioni = evening
kazi = work
tumaini = hope
wimbo = song
adhama = honor