kichwa = head
bahari = sea
roho = soul
wakati = alarm
shukuru = thanks
barua = letter
bustani = garden
chama = society
karamu = party
jicho = eye
chakula = food
degaga = glasses
tumaini = hope
siri = secret
wimbo = song
askari = police
adui = enemy
dhoruba = storm
kijana = boy
rafiki = friend
jiwe = stone
kamba = rope
chunga = pot
chanjo = scissors
kisu = knife
pombe = beer
chapati = bread
ajabu = wonder
rangi = color
adhama = honor
ujuzi = knowledge
kanisa = church
tabibu = doctor
afisi = office
keja = house
saduku = box
kioo = mirror
tofaa = apple
kuku = chicken
sauti = voice
kazi = work
ufu = death
jioni = evening
bibi = grandmother
tumbili = monkey
skati = skirt
kofia = hat
baskeli = bike
basi = bus
tunda = fruit
anga = sky
kaputula = pants
likizo = holidays
baba = father
samaki = fish
lango = door
kitanda = bed
kiti = chair