baskeli = bike
saduku = box
kamba = rope
barua = letter
wimbo = song
bahari = sea
kijana = boy
tabibu = doctor
samaki = fish
chunga = pot
basi = bus
lango = door
keja = house
kichwa = head
jicho = eye
roho = soul
tumbili = monkey
dhoruba = storm
kanisa = church
karamu = party
siri = secret
shukuru = thanks
rafiki = friend
baba = father
bibi = grandmother
kioo = mirror
kisu = knife
afisi = office
skati = skirt
jiwe = stone
chakula = food
pombe = beer
chama = society
askari = police
adhama = honor
wakati = alarm
ajabu = wonder
chanjo = scissors
kitanda = bed
kofia = hat
tunda = fruit
tofaa = apple
chapati = bread
anga = sky
adui = enemy
ujuzi = knowledge
ufu = death
tumaini = hope
sauti = voice
bustani = garden
kiti = chair
kuku = chicken
degaga = glasses
likizo = holidays
jioni = evening
kaputula = pants
kazi = work
rangi = color